R   1920    1080
NO 225,30,6   
SO ./path_to_the_south_texture
WE ./path_to_the_west_texture
EA ./path_to_the_east_texture

S ./path_to_the_sprite_texture
F 220,100,0
C  225,30,6

111111111111111
1111111
100E1
111111

